+---+---+---+---+---+---+---+---+---+---+---+---+---+---+---+---+
|   |                                               |           |
+   +---+   +   +---+---+   +   +   +---+---+   +---+---+   +   +
|   |       |       |       |   |       |                   |   |
+   +   +---+---+   +   +---+   +---+   +   +---+---+   +---+   +
|                   |       |   |       |       |           |   |
+   +   +---+---+   +---+   +   +   +---+---+   +---+   +   +   +
|   |       |       |                   |       |       |       |
+   +---+   +   +   +   +---+---+   +   +   +   +   +---+---+   +
|   |           |           |       |   |   |           |       |
+   +   +   +---+---+   +   +---+---+---+   +---+   +   +   +   +
|       |       |       |   |       |       |       |       |   |
+   +---+---+   +   +---+   +---+   +   +   +   +---+   +---+   +
|               |       |   |           |           |       |   |
+   +   +   +---+---+   +   +   +---+   +---+   +   +   +   +   +
|   |   |                   |       |   |       |       |       |
+---+   +---+   +---+---+   +   +   +   +   +   +---+   +---+   +
|   |   |           |   |   |       |       |   |       |       |
+   +   +   +---+---+   +---+---+---+   +---+---+---+---+   +   +
|               |       |       |       |   |       |       |   |
+   +---+---+   +   +---+---+   +---+---+   +   +   +   +---+---+
|       |                           |   |       |               |
+---+   +   +   +---+---+   +   +---+   +---+   +---+---+   +   +
|   |       |       |       |       |   |       |   |       |   |
+   +---+   +---+   +   +---+---+   +   +   +---+   +   +---+   +
|   |       |               |                   |           |   |
+   +   +   +   +---+---+   +   +---+---+---+   +---+---+   +   +
|       |           |               |       |                   |
+   +   +---+   +   +---+---+   +   +   +---+---+   +   +   +   +
|   |   |       |       |       |                   |   |   |   |
+   +   +   +---+---+   +   +---+---+   +---+---+   +---+---+   +
|   |                                       |                   |
+---+---+---+---+---+---+---+---+---+---+---+---+---+---+---+---+
