+---+---+---+---+---+---+---+---+---+---+---+---+---+---+---+---+
|                                           |                   |
+   +---+   +---+---+---+---+---+---+---+   +---+   +---+---+   +
|   |           |                                       |       |
+   +   +---+---+   +---+---+---+---+---+   +---+   +---+   +   +
|           |                   |       |   |           |   |   |
+   +---+---+   +---+---+---+---+   +   +   +---+   +---+   +   +
|           |               |   |   |   |               |       |
+---+   +---+   +   +---+---+   +   +   +   +---+   +---+   +   +
|           |   |           |   |   |   |               |   |   |
+   +---+   +---+---+   +---+   +   +   +   +---+   +---+   +   +
|                   |       |   |   |   |               |       |
+   +---+---+   +---+   +   +   +   +   +---+---+   +---+   +   +
|               |   |   |           |       |           |   |   |
+---+   +   +---+   +---+   +   +---+---+   +---+   +---+   +   +
|       |               |   |       |   |       |       |   |   |
+---+---+   +   +---+   +---+   +   +   +---+   +   +---+   +   +
|           |               |           |               |       |
+   +---+   +---+   +---+   +---+---+   +---+---+---+   +   +   +
|                           |       |           |       |   |   |
+   +---+---+   +---+   +---+   +   +   +   +---+   +   +   +   +
|                       |       |   |   |           |   |       |
+---+   +---+---+   +---+   +   +   +   +---+   +---+   +   +   +
|       |                   |   |   |                   |   |   |
+---+   +---+   +---+   +---+   +   +---+---+---+---+---+   +   +
|                               |                   |       |   |
+   +---+---+---+---+---+---+   +   +---+   +---+   +   +---+   +
|   |                       |                   |       |   |   |
+   +   +---+   +---+   +   +   +---+   +---+---+---+   +   +   +
|                       |               |                   |   |
+   +   +---+---+   +---+   +---+   +---+---+---+---+---+   +   +
|   |                               |                           |
+---+---+---+---+---+---+---+---+---+---+---+---+---+---+---+---+
